2 2
1 5 5 5 5 5 5 5 5 5 5 5 5 5 5 5 5 5 5 5 5 5 5 5
1 0 0 0 0 0 0 0 0 0 0 0 0 0 0 0 0 0 0 0 0 0 0 3
3 0 0 0 0 0 0 0 0 0 0 0 0 0 0 0 0 0 0 0 0 0 0 3
3 0 1 1 1 1 1 1 1 1 1 1 1 1 1 1 1 1 1 1 1 1 0 3
3 0 0 0 0 0 0 0 0 0 0 0 0 0 0 0 0 0 0 0 0 2 0 3
3 0 0 0 0 0 0 0 0 0 0 0 0 0 0 0 0 0 0 0 0 3 0 3
3 0 0 3 4 4 4 4 4 4 4 4 4 4 4 4 4 4 0 0 0 4 0 3
3 0 0 3 0 0 0 0 0 0 0 0 0 0 0 0 0 5 0 0 0 5 0 3
3 0 0 3 0 0 0 0 0 0 0 0 0 0 0 0 0 1 0 0 0 1 0 3
3 0 0 3 0 0 5 1 2 3 4 5 1 2 3 0 0 2 0 0 0 2 0 3
3 0 0 3 0 0 4 0 0 0 0 0 0 0 4 0 0 3 0 0 0 3 0 3
3 0 0 3 0 0 3 0 0 0 0 0 0 0 5 0 0 4 0 0 0 4 0 3
3 0 0 3 0 0 2 0 0 8 8 8 0 0 1 0 0 5 0 0 0 5 0 3
3 0 0 3 0 0 1 0 0 8 7 0 0 0 1 0 0 1 0 0 0 1 0 3
3 0 0 3 0 0 5 0 0 8 8 8 0 0 1 0 0 2 0 0 0 2 0 3
3 0 0 3 0 0 4 0 0 0 0 0 0 0 8 0 0 3 0 0 0 3 0 3
3 0 0 3 0 0 3 0 0 0 0 0 0 0 0 0 0 4 0 0 0 4 0 3
3 0 0 3 0 0 0 0 0 0 0 0 0 0 0 0 0 5 0 0 0 5 0 3
3 0 0 3 0 0 1 1 1 1 1 1 1 1 1 1 1 1 0 0 0 1 0 3
3 0 0 3 0 0 0 0 0 0 0 0 0 0 0 0 0 0 0 0 0 2 0 3
3 0 0 0 0 0 0 0 0 0 0 0 0 0 0 0 0 0 0 0 0 3 0 3
3 0 0 2 2 2 2 2 2 2 2 2 2 2 2 2 2 2 2 2 5 4 0 3
3 0 0 0 0 0 0 0 0 0 0 0 0 0 0 0 0 0 0 0 0 0 0 1
4 4 4 4 4 4 4 4 4 4 4 4 4 4 4 4 4 4 4 4 4 4 4 1
